//MAP CONVERTED BY dmm2tgm.py THIS HEADER COMMENT PREVENTS RECONVERSION, DO NOT REMOVE
"e" = (
/obj/effect/turf_decal/trimline/opaque/cybersunteal/warning{
	dir = 8
	},
/obj/structure/cable/cyan{
	icon_state = "6-8"
	},
/obj/structure/cable/cyan{
	icon_state = "4-8"
	},
/obj/effect/turf_decal/borderfloorwhite{
	dir = 4
	},
/turf/open/floor/plasteel/mono/white,
/area/ship/bridge)
"h" = (
/obj/machinery/button/door{
	id = "bam";
	pixel_y = 23;
	pixel_x = 9;
	name = "blast shutter control"
	},
/obj/machinery/button/shieldwallgen{
	pixel_y = 21;
	id = "bams"
	},
/obj/effect/turf_decal/trimline/opaque/cybersunteal/corner{
	dir = 1
	},
/obj/effect/turf_decal/trimline/opaque/cybersunteal/corner{
	dir = 8
	},
/obj/structure/chair/handrail,
/obj/effect/turf_decal/borderfloorwhite{
	dir = 4
	},
/obj/effect/turf_decal/siding/white{
	dir = 1
	},
/turf/open/floor/plasteel/mono/white,
/area/ship/bridge)
"i" = (
/obj/structure/chair/handrail{
	dir = 1
	},
/obj/effect/turf_decal/trimline/opaque/cybersunteal/corner{
	dir = 8
	},
/obj/effect/turf_decal/trimline/opaque/cybersunteal/corner{
	dir = 1
	},
/obj/effect/turf_decal/borderfloorwhite{
	dir = 4
	},
/obj/effect/turf_decal/siding/white,
/obj/structure/closet/secure_closet/wall/directional/south,
/turf/open/floor/plasteel/mono/white,
/area/ship/bridge)
"o" = (
/obj/machinery/power/smes/shuttle/precharged{
	dir = 1
	},
/obj/structure/platform/ship_two{
	dir = 5
	},
/obj/structure/cable/cyan{
	icon_state = "0-8"
	},
/obj/machinery/door/poddoor/shutters{
	dir = 4;
	id = "bam2"
	},
/obj/structure/window/reinforced{
	dir = 8
	},
/turf/open/floor/engine/hull/reinforced/interior,
/area/ship/bridge)
"q" = (
/obj/structure/chair/comfy/shuttle{
	dir = 8;
	name = "grav couch";
	pixel_y = 0;
	pixel_x = -3
	},
/obj/structure/railing/thin/corner{
	dir = 8
	},
/obj/structure/railing/thin/corner{
	dir = 1
	},
/obj/machinery/door/window/brigdoor/eastleft,
/obj/machinery/holopad/secure,
/obj/structure/cable/cyan{
	icon_state = "1-4"
	},
/obj/structure/cable/cyan{
	icon_state = "2-4"
	},
/turf/open/floor/plasteel/patterned/brushed,
/area/ship/bridge)
"r" = (
/obj/effect/turf_decal/trimline/opaque/cybersunteal/arrow_cw,
/obj/effect/turf_decal/trimline/opaque/cybersunteal/arrow_ccw{
	dir = 1
	},
/obj/machinery/power/apc/auto_name/directional/north,
/obj/machinery/light_switch{
	dir = 2;
	pixel_x = 11;
	pixel_y = 22
	},
/obj/structure/cable/cyan{
	icon_state = "0-2"
	},
/obj/effect/turf_decal/siding/white{
	dir = 1
	},
/turf/open/floor/plasteel/mono/white,
/area/ship/bridge)
"u" = (
/obj/machinery/door/poddoor/shutters/preopen{
	id = "bam";
	dir = 4
	},
/obj/effect/turf_decal/industrial/warning{
	dir = 4;
	color = "#FFFFFF"
	},
/obj/machinery/door/firedoor/border_only{
	dir = 8
	},
/obj/machinery/power/shieldwallgen/atmos/roundstart{
	id = "bams"
	},
/obj/structure/cable/cyan{
	icon_state = "0-2"
	},
/turf/open/floor/plasteel/tech/grid,
/area/ship/bridge)
"v" = (
/obj/machinery/power/shuttle/engine/electric{
	dir = 4
	},
/obj/structure/window/reinforced{
	dir = 1
	},
/obj/structure/window/reinforced,
/obj/structure/cable/cyan{
	icon_state = "0-4"
	},
/turf/open/floor/engine/hull/reinforced,
/area/ship/bridge)
"y" = (
/obj/machinery/stasis{
	dir = 1
	},
/obj/structure/platform/ship_two{
	dir = 8
	},
/obj/structure/curtain/cloth{
	dir = 4
	},
/obj/effect/turf_decal/trimline/opaque/cybersunteal/end{
	dir = 8
	},
/obj/machinery/light/directional/south,
/obj/effect/turf_decal/siding/white{
	dir = 10
	},
/turf/open/floor/plasteel/mono/white,
/area/ship/bridge)
"A" = (
/turf/template_noop,
/area/template_noop)
"C" = (
/obj/docking_port/mobile{
	dir = 8;
	name = "Trauma Team Bambulance";
	preferred_direction = 4
	},
/obj/machinery/door/poddoor/shutters/preopen{
	id = "bam";
	dir = 4
	},
/obj/effect/turf_decal/industrial/warning{
	dir = 4;
	color = "#FFFFFF"
	},
/obj/machinery/door/firedoor/border_only{
	dir = 8
	},
/obj/structure/cable/cyan{
	icon_state = "1-8"
	},
/obj/structure/cable/cyan{
	icon_state = "2-8"
	},
/turf/open/floor/plasteel/tech/grid,
/area/ship/bridge)
"E" = (
/obj/effect/turf_decal/industrial/warning/fulltile{
	color = "#FFFFFF"
	},
/obj/machinery/computer/helm{
	dir = 4
	},
/obj/structure/railing/thin{
	dir = 1;
	layer = 2.89
	},
/obj/structure/railing/thin{
	dir = 10
	},
/turf/open/floor/plasteel/tech,
/area/ship/bridge)
"G" = (
/obj/structure/railing/thin{
	dir = 8
	},
/obj/structure/window/plasma/reinforced{
	dir = 4
	},
/obj/structure/table/reinforced,
/obj/machinery/power/terminal{
	dir = 8
	},
/obj/structure/cable/cyan,
/obj/item/radio/intercom/directional/south,
/obj/item/megaphone/command{
	pixel_x = -5;
	pixel_y = 5
	},
/obj/machinery/button/shieldwallgen{
	pixel_y = -19;
	id = "bams";
	dir = 1;
	pixel_x = -12
	},
/turf/open/floor/plasteel/patterned/brushed,
/area/ship/bridge)
"H" = (
/obj/structure/grille,
/obj/structure/window/reinforced/fulltile/shuttle,
/obj/machinery/door/poddoor/shutters{
	dir = 4;
	id = "bam2"
	},
/turf/open/floor/engine/hull/reinforced,
/area/ship/bridge)
"I" = (
/obj/effect/turf_decal/trimline/opaque/cybersunteal/arrow_cw,
/obj/effect/turf_decal/trimline/opaque/cybersunteal/arrow_ccw{
	dir = 1
	},
/obj/effect/turf_decal/siding/white,
/obj/machinery/computer/crew/wall/directional/south,
/turf/open/floor/plasteel/mono/white,
/area/ship/bridge)
"L" = (
/obj/machinery/power/smes/shuttle/precharged{
	dir = 2
	},
/obj/structure/platform/ship_two{
	dir = 6
	},
/obj/structure/cable/cyan{
	icon_state = "0-8"
	},
/obj/machinery/door/poddoor/shutters{
	dir = 4;
	id = "bam2"
	},
/obj/structure/window/reinforced{
	dir = 8
	},
/turf/open/floor/engine/hull/reinforced/interior,
/area/ship/bridge)
"P" = (
/obj/structure/cable/cyan{
	icon_state = "4-8"
	},
/obj/structure/cable/cyan{
	icon_state = "1-8"
	},
/turf/open/floor/plasteel/mono/white,
/area/ship/bridge)
"R" = (
/obj/machinery/stasis{
	dir = 1
	},
/obj/structure/platform/ship_two{
	dir = 8
	},
/obj/structure/curtain/cloth{
	dir = 4
	},
/obj/effect/turf_decal/trimline/opaque/cybersunteal/end{
	dir = 8
	},
/obj/machinery/light/directional/north,
/obj/effect/turf_decal/siding/white{
	dir = 9
	},
/turf/open/floor/plasteel/mono/white,
/area/ship/bridge)
"S" = (
/obj/structure/cable/cyan{
	icon_state = "4-9"
	},
/obj/machinery/door/poddoor/shutters/preopen{
	id = "bam";
	dir = 4
	},
/obj/effect/turf_decal/industrial/warning{
	dir = 4;
	color = "#FFFFFF"
	},
/obj/machinery/door/firedoor/border_only{
	dir = 8
	},
/obj/machinery/power/shieldwallgen/atmos/roundstart{
	id = "bams";
	dir = 1
	},
/obj/structure/cable/cyan{
	icon_state = "0-1"
	},
/turf/open/floor/plasteel/tech/grid,
/area/ship/bridge)
"U" = (
/obj/structure/cable/cyan{
	icon_state = "4-8"
	},
/turf/open/floor/plasteel/stairs/modern/dark{
	dir = 8
	},
/area/ship/bridge)
"X" = (
/obj/structure/railing/thin{
	dir = 8
	},
/obj/structure/window/plasma/reinforced{
	dir = 4
	},
/obj/structure/table/reinforced,
/obj/machinery/power/terminal{
	dir = 8
	},
/obj/structure/cable/cyan{
	icon_state = "0-2"
	},
/obj/item/radio/intercom/wideband/directional/north{
	pixel_x = 5
	},
/obj/item/paper_bin{
	pixel_x = 5
	},
/obj/item/clipboard{
	pixel_y = 6;
	pixel_x = -5
	},
/obj/item/pen/sleepy{
	pixel_y = 6;
	pixel_x = -5
	},
/obj/machinery/button/door{
	id = "bam2";
	pixel_y = 23;
	pixel_x = -9;
	name = "engine shutter control"
	},
/turf/open/floor/plasteel/patterned/brushed,
/area/ship/bridge)
"Y" = (
/turf/closed/wall/mineral/titanium/nodiagonal,
/area/ship/bridge)

(1,1,1) = {"
A
v
H
v
A
"}
(2,1,1) = {"
Y
L
E
o
Y
"}
(3,1,1) = {"
Y
X
q
G
Y
"}
(4,1,1) = {"
Y
R
U
y
Y
"}
(5,1,1) = {"
Y
r
P
I
Y
"}
(6,1,1) = {"
Y
h
e
i
Y
"}
(7,1,1) = {"
Y
u
C
S
Y
"}
