//MAP CONVERTED BY dmm2tgm.py THIS HEADER COMMENT PREVENTS RECONVERSION, DO NOT REMOVE
"ag" = (
/obj/structure/cable{
	icon_state = "4-8"
	},
/obj/structure/cable{
	icon_state = "1-8"
	},
/obj/machinery/atmospherics/pipe/simple/scrubbers/hidden/layer4{
	dir = 10
	},
/obj/effect/decal/cleanable/dirt/dust,
/obj/item/lighter{
	pixel_y = -2;
	pixel_x = 10
	},
/turf/open/floor/plasteel/patterned,
/area/ship/cargo)
"aI" = (
/obj/machinery/atmospherics/components/unary/outlet_injector/on{
	dir = 4;
	name = "exhaust injector"
	},
/turf/open/floor/engine/hull,
/area/ship/external/dark)
"bn" = (
/obj/structure/railing/thin/corner{
	dir = 1
	},
/obj/structure/cable{
	icon_state = "1-2"
	},
/obj/item/storage/bag/trash{
	pixel_x = -7
	},
/obj/machinery/atmospherics/components/unary/vent_scrubber/on/layer4{
	on = 0
	},
/turf/open/floor/plasteel/tech,
/area/ship/engineering/engine)
"dP" = (
/obj/machinery/atmospherics/pipe/simple/supply/hidden/layer2{
	dir = 4
	},
/obj/machinery/atmospherics/pipe/simple/scrubbers/hidden/layer4{
	dir = 8
	},
/obj/structure/cable{
	icon_state = "4-8"
	},
/obj/effect/decal/cleanable/dirt/dust,
/turf/open/floor/plasteel/patterned,
/area/ship/cargo)
"ek" = (
/obj/machinery/atmospherics/pipe/simple/supply/hidden/layer2{
	dir = 4
	},
/obj/structure/catwalk/over/plated_catwalk/dark,
/obj/machinery/door/airlock/grunge{
	dir = 4;
	name = "Engine Room";
	req_access = list(12)
	},
/obj/machinery/door/firedoor/border_only{
	dir = 4
	},
/obj/machinery/door/firedoor/border_only{
	dir = 8
	},
/obj/structure/cable{
	icon_state = "4-10"
	},
/obj/machinery/atmospherics/pipe/simple/scrubbers/hidden/layer4{
	dir = 8
	},
/turf/open/floor/plating,
/area/ship/engineering/engine)
"fj" = (
/obj/structure/grille,
/obj/structure/window/plasma/reinforced/plastitanium,
/obj/machinery/door/poddoor/shutters{
	id = "javelin_helm_shutters"
	},
/obj/machinery/atmospherics/pipe/simple/scrubbers/hidden/layer4{
	dir = 10
	},
/turf/open/floor/plating,
/area/ship/bridge)
"fw" = (
/obj/effect/turf_decal/hardline_small,
/obj/structure/cable{
	icon_state = "1-2"
	},
/obj/structure/cable{
	icon_state = "2-6"
	},
/obj/structure/cable{
	icon_state = "2-8"
	},
/obj/machinery/atmospherics/pipe/simple/scrubbers/hidden/layer4{
	dir = 5
	},
/obj/machinery/atmospherics/pipe/manifold/supply/hidden/layer2{
	dir = 1
	},
/obj/structure/cable{
	icon_state = "2-5"
	},
/obj/item/storage/toolbox/drone{
	pixel_y = 7
	},
/turf/open/floor/plasteel/tech,
/area/ship/engineering/engine)
"fS" = (
/obj/structure/chair/handrail{
	dir = 1
	},
/obj/machinery/atmospherics/components/unary/vent_pump/on/layer2{
	dir = 1
	},
/obj/structure/closet/crate/secure/weapon{
	name = "combat gear crate";
	desc = "A secure weapons and combat gear crate."
	},
/obj/item/clothing/head/helmet/inteq{
	pixel_x = -7
	},
/obj/item/storage/belt/security/webbing/inteq{
	pixel_x = 8;
	pixel_y = 4
	},
/obj/item/clothing/glasses/hud/security/sunglasses/inteq,
/obj/item/melee/knife/survival,
/obj/item/clothing/suit/armor/vest,
/obj/item/clothing/mask/balaclava/inteq,
/obj/item/melee/baton/loaded,
/obj/item/clothing/gloves/combat,
/obj/item/attachment/rail_light,
/obj/item/attachment/rail_light,
/obj/item/ammo_box/magazine/skm_762_40{
	pixel_x = -7
	},
/obj/item/ammo_box/magazine/skm_762_40{
	pixel_x = -7
	},
/obj/item/ammo_box/magazine/skm_762_40{
	pixel_x = -7
	},
/obj/item/ammo_box/magazine/co9mm{
	pixel_x = -5
	},
/obj/item/ammo_box/magazine/co9mm{
	pixel_x = -5
	},
/obj/item/ammo_box/magazine/co9mm{
	pixel_x = -5
	},
/obj/item/ammo_box/magazine/co9mm{
	pixel_x = -5
	},
/obj/item/ammo_box/magazine/co9mm{
	pixel_x = -5
	},
/obj/item/reagent_containers/spray/pepper,
/obj/item/storage/box/zipties,
/obj/machinery/firealarm/directional/south{
	pixel_x = 5
	},
/obj/structure/extinguisher_cabinet/directional/south{
	pixel_x = -7
	},
/turf/open/floor/plasteel/patterned,
/area/ship/cargo)
"gu" = (
/obj/structure/grille,
/obj/structure/window/reinforced{
	dir = 4
	},
/obj/structure/window/reinforced{
	dir = 1
	},
/obj/structure/window/reinforced{
	dir = 8
	},
/obj/structure/window/reinforced,
/obj/structure/cable/yellow{
	icon_state = "4-8"
	},
/obj/machinery/door/poddoor{
	id = "javelin_engine_lockdown";
	dir = 4
	},
/turf/open/floor/plating,
/area/ship/engineering/engine)
"hp" = (
/obj/machinery/atmospherics/pipe/simple/supply/hidden/layer2{
	dir = 4
	},
/obj/structure/cable{
	icon_state = "4-8"
	},
/obj/structure/cable{
	icon_state = "1-8"
	},
/obj/effect/turf_decal/siding/thinplating/dark,
/obj/effect/turf_decal/siding/thinplating/dark{
	dir = 1
	},
/obj/effect/turf_decal/trimline/opaque/yellow/warning{
	dir = 1
	},
/obj/effect/turf_decal/trimline/opaque/yellow/warning,
/obj/machinery/atmospherics/pipe/simple/scrubbers/hidden/layer4{
	dir = 8
	},
/turf/open/floor/plasteel/dark,
/area/ship/bridge)
"hF" = (
/obj/machinery/airalarm/directional/south,
/obj/effect/decal/cleanable/dirt/dust,
/obj/structure/closet/crate/secure/gear{
	name = "utility gear crate";
	desc = "A secure utility crate for mining and EVA gear."
	},
/obj/item/pickaxe/drill,
/obj/item/storage/bag/ore,
/obj/item/tank/internals/oxygen,
/obj/item/tank/internals/oxygen,
/obj/item/tank/internals/oxygen,
/obj/item/mining_scanner,
/turf/open/floor/plasteel/patterned,
/area/ship/cargo)
"kr" = (
/obj/effect/turf_decal/techfloor{
	dir = 9
	},
/obj/machinery/airalarm/directional/west{
	pixel_y = 3
	},
/obj/machinery/atmospherics/pipe/simple/scrubbers/hidden/layer4,
/obj/machinery/computer/crew{
	icon_state = "computer-left"
	},
/turf/open/floor/plasteel/telecomms_floor,
/area/ship/bridge)
"kU" = (
/turf/closed/wall/mineral/plastitanium,
/area/ship/bridge)
"kX" = (
/obj/structure/railing{
	layer = 3.31
	},
/obj/machinery/door/firedoor/border_only{
	dir = 4
	},
/turf/open/floor/plasteel/stairs/left{
	dir = 4
	},
/area/ship/bridge)
"lI" = (
/obj/machinery/atmospherics/components/unary/vent_scrubber/on/layer4{
	dir = 1;
	on = 0
	},
/obj/machinery/light/directional/south,
/obj/structure/closet/crate/medical,
/obj/item/roller{
	pixel_y = 5
	},
/obj/item/storage/firstaid/regular{
	pixel_x = 5
	},
/obj/item/storage/firstaid/medical{
	pixel_x = -5
	},
/obj/item/storage/firstaid/brute,
/obj/item/storage/firstaid/fire,
/turf/open/floor/plasteel/patterned,
/area/ship/cargo)
"nk" = (
/obj/machinery/power/terminal{
	dir = 8
	},
/obj/structure/railing/thin{
	dir = 8
	},
/obj/structure/cable{
	icon_state = "0-2"
	},
/obj/structure/catwalk/over,
/obj/machinery/computer/cryopod/directional/north,
/obj/machinery/cryopod{
	dir = 8
	},
/turf/open/floor/plating,
/area/ship/engineering/engine)
"nv" = (
/obj/structure/table/wood,
/obj/effect/spawner/random/food_or_drink/ration,
/obj/effect/spawner/random/food_or_drink/ration,
/obj/effect/spawner/random/food_or_drink/ration,
/obj/item/reagent_containers/food/drinks/bottle/whiskey{
	pixel_x = -11;
	pixel_y = 12
	},
/obj/effect/spawner/random/food_or_drink/donkpockets{
	pixel_x = -1;
	pixel_y = -4
	},
/obj/item/food/hotdog{
	pixel_x = -2;
	pixel_y = 5
	},
/obj/structure/window/reinforced/tinted/frosted{
	dir = 4
	},
/turf/open/floor/carpet/orange,
/area/ship/bridge)
"oE" = (
/obj/effect/turf_decal/siding/thinplating/dark/corner,
/obj/effect/turf_decal/trimline/opaque/yellow/corner,
/obj/machinery/atmospherics/components/unary/vent_scrubber/on/layer4{
	dir = 1;
	filter_types = list("n2");
	on = 0
	},
/obj/effect/turf_decal/siding/thinplating/dark/corner,
/obj/item/paper/crumpled,
/obj/effect/decal/cleanable/dirt/dust,
/turf/open/floor/plasteel/dark,
/area/ship/bridge)
"oO" = (
/obj/effect/turf_decal/industrial/warning/fulltile,
/obj/machinery/door/poddoor{
	id = "javelin_dock_doors";
	dir = 4
	},
/obj/docking_port/mobile{
	dir = 8;
	name = "javelin dock";
	launch_status = 0;
	preferred_direction = 4
	},
/turf/open/floor/engine/hull/reinforced/interior,
/area/ship/cargo)
"qu" = (
/turf/template_noop,
/area/template_noop)
"qH" = (
/obj/machinery/atmospherics/components/unary/vent_pump/on/layer2{
	dir = 1
	},
/obj/effect/turf_decal/siding/thinplating/dark{
	dir = 8
	},
/obj/effect/turf_decal/trimline/opaque/yellow/warning{
	dir = 8
	},
/obj/item/binoculars,
/turf/open/floor/plasteel/dark,
/area/ship/bridge)
"rf" = (
/obj/machinery/power/terminal{
	dir = 8
	},
/obj/structure/railing/thin{
	dir = 8
	},
/obj/structure/cable{
	icon_state = "0-1"
	},
/obj/structure/catwalk/over,
/obj/structure/closet/wall/orange/directional/east{
	name = "engineering closet"
	},
/obj/item/clothing/glasses/welding{
	pixel_x = 1;
	pixel_y = -3
	},
/obj/item/weldingtool/electric,
/obj/item/clothing/gloves/color/yellow,
/obj/item/construction/rcd/loaded,
/obj/item/areaeditor/shuttle{
	pixel_y = -3;
	pixel_x = 4
	},
/obj/item/storage/box/stockparts/t3,
/obj/item/storage/part_replacer,
/obj/item/storage/box/lights/bulbs{
	pixel_y = 7
	},
/obj/effect/decal/cleanable/dirt/dust,
/obj/item/storage/toolbox/electrical,
/obj/item/reagent_containers/spray/cleaner{
	pixel_x = -3;
	pixel_y = 1
	},
/obj/item/radio/intercom/directional/south{
	frequency = 1347;
	freqlock = 1;
	freerange = 1
	},
/turf/open/floor/plating,
/area/ship/engineering/engine)
"rG" = (
/obj/structure/cable{
	icon_state = "1-4"
	},
/obj/machinery/button/door{
	pixel_y = -22;
	id = "javelin_dock_doors";
	dir = 1;
	pixel_x = -4;
	name = "docking doors toggle"
	},
/obj/machinery/button/shieldwallgen{
	pixel_x = 5;
	pixel_y = -20;
	id = "javelin_holo";
	dir = 1
	},
/obj/effect/decal/cleanable/dirt/dust,
/turf/open/floor/plasteel/patterned,
/area/ship/cargo)
"rM" = (
/obj/machinery/power/smes/shuttle/precharged{
	dir = 4
	},
/obj/structure/cable/yellow{
	icon_state = "0-8"
	},
/turf/open/floor/plating,
/area/ship/engineering/engine)
"sZ" = (
/obj/machinery/porta_turret/ship/inteq/heavy{
	dir = 6;
	id = "javelin";
	name = "Vanguard Overwatch turret"
	},
/turf/closed/wall/mineral/plastitanium,
/area/ship/cargo)
"ud" = (
/obj/effect/turf_decal/industrial/traffic,
/obj/effect/turf_decal/industrial/traffic{
	dir = 6
	},
/obj/effect/turf_decal/borderfloorblack/corner{
	dir = 1
	},
/obj/structure/cable{
	icon_state = "0-2"
	},
/obj/structure/ore_box,
/obj/machinery/power/apc/auto_name/directional/north,
/obj/machinery/light_switch{
	pixel_x = 12;
	pixel_y = 20
	},
/turf/open/floor/plasteel/patterned/cargo_one,
/area/ship/cargo)
"uj" = (
/obj/structure/table/reinforced,
/obj/effect/turf_decal/techfloor/corner{
	dir = 1
	},
/obj/machinery/atmospherics/pipe/simple/scrubbers/hidden/layer4,
/obj/item/pen/collectible/inteq{
	pixel_x = 5
	},
/obj/item/radio/intercom/table{
	dir = 1;
	pixel_x = -8;
	pixel_y = 11;
	freerange = 1;
	freqlock = 1;
	frequency = 1347
	},
/obj/item/radio/intercom/wideband/table{
	dir = 1;
	pixel_x = 9;
	pixel_y = 11
	},
/obj/item/reagent_containers/food/drinks/coffee{
	pixel_x = -9;
	pixel_y = 4
	},
/turf/open/floor/plasteel/tech,
/area/ship/bridge)
"uw" = (
/obj/machinery/atmospherics/pipe/simple/supply/hidden/layer2{
	dir = 4
	},
/obj/structure/cable{
	icon_state = "4-8"
	},
/obj/effect/turf_decal/siding/thinplating/dark{
	dir = 1
	},
/obj/effect/turf_decal/trimline/opaque/yellow/warning{
	dir = 1
	},
/obj/machinery/atmospherics/pipe/manifold/scrubbers/hidden/layer4{
	dir = 1
	},
/obj/effect/decal/cleanable/dirt/dust,
/turf/open/floor/plasteel/dark,
/area/ship/bridge)
"uI" = (
/obj/structure/grille,
/obj/structure/window/plasma/reinforced/plastitanium,
/obj/machinery/door/poddoor/shutters{
	id = "javelin_helm_shutters"
	},
/turf/open/floor/plating,
/area/ship/bridge)
"vp" = (
/obj/structure/grille,
/obj/structure/window/plasma/reinforced/plastitanium,
/obj/machinery/door/poddoor/shutters{
	id = "javelin_helm_shutters";
	dir = 4
	},
/turf/open/floor/plating,
/area/ship/bridge)
"yi" = (
/obj/machinery/power/smes/engineering{
	input_level = 5000;
	output_level = 15000
	},
/obj/machinery/light_switch{
	dir = 8;
	pixel_x = 20;
	pixel_y = -11
	},
/obj/machinery/button/door{
	dir = 8;
	pixel_x = 21;
	pixel_y = -2;
	id = "javelin_engine_lockdown";
	name = "engine lockdown toggle"
	},
/obj/structure/cable{
	icon_state = "0-10"
	},
/obj/machinery/light/small/directional/north,
/turf/open/floor/plating,
/area/ship/engineering/engine)
"zK" = (
/obj/machinery/microwave,
/obj/structure/table/wood,
/obj/structure/window/reinforced/tinted/frosted{
	dir = 1
	},
/obj/structure/window/reinforced/tinted/frosted{
	dir = 4
	},
/turf/open/floor/carpet/orange,
/area/ship/bridge)
"Ai" = (
/obj/machinery/turretid/ship{
	pixel_y = 4;
	pixel_x = 24;
	id = "javelin";
	req_access = list(1)
	},
/obj/effect/turf_decal/techfloor{
	dir = 5
	},
/obj/machinery/computer/cargo{
	icon_state = "computer-right";
	pixel_y = 0
	},
/obj/machinery/button/door{
	pixel_x = 9;
	pixel_y = -13;
	name = "docking doors toggle";
	id = "javelin_dock_doors"
	},
/obj/machinery/button/shieldwallgen{
	pixel_y = -15;
	id = "javelin_holo"
	},
/obj/machinery/button/door{
	pixel_x = -9;
	pixel_y = -13;
	id = "javelin_helm_shutters";
	name = "helm shutters toggle"
	},
/turf/open/floor/plasteel/telecomms_floor,
/area/ship/bridge)
"AD" = (
/obj/structure/platform/ship_three{
	layer = 2.8;
	dir = 10
	},
/obj/structure/railing{
	dir = 10;
	layer = 3.081
	},
/obj/machinery/suit_storage_unit/inherit,
/obj/machinery/light/directional/north,
/obj/effect/turf_decal/borderfloorblack{
	dir = 1
	},
/obj/item/clothing/mask/gas/inteq,
/obj/item/tank/jetpack/oxygen,
/obj/machinery/door/firedoor/border_only{
	dir = 4
	},
/obj/item/clothing/suit/space/hardsuit/security/inteq,
/turf/open/floor/plasteel/patterned/cargo_one,
/area/ship/bridge)
"BL" = (
/obj/machinery/power/terminal{
	dir = 1
	},
/obj/structure/cable/yellow{
	icon_state = "0-2"
	},
/obj/machinery/atmospherics/pipe/simple/supply/hidden/layer2{
	dir = 4
	},
/obj/effect/turf_decal/hardline_small/right,
/obj/machinery/atmospherics/pipe/simple/scrubbers/hidden/layer4{
	dir = 8
	},
/obj/effect/decal/cleanable/dirt/dust,
/obj/item/multitool{
	pixel_x = 7
	},
/turf/open/floor/plasteel/tech,
/area/ship/engineering/engine)
"BP" = (
/obj/machinery/light/directional/south,
/obj/effect/turf_decal/siding/thinplating/dark{
	dir = 10
	},
/obj/effect/turf_decal/trimline/opaque/yellow/warning{
	dir = 10
	},
/obj/machinery/autolathe,
/obj/item/stack/sheet/plastic/twenty{
	pixel_y = 4;
	pixel_x = 4
	},
/obj/item/stack/sheet/glass/twenty{
	pixel_x = 4;
	pixel_y = 3
	},
/obj/item/stack/sheet/plasteel/twenty{
	pixel_x = 5
	},
/obj/item/stack/sheet/metal/fifty{
	pixel_x = 3
	},
/obj/effect/decal/cleanable/dirt/dust,
/turf/open/floor/plasteel/dark,
/area/ship/bridge)
"BR" = (
/obj/structure/railing/thin,
/obj/structure/catwalk/over,
/obj/machinery/telecomms/relay/preset/inteq{
	name = "Inteq relay"
	},
/obj/machinery/light/small/directional/west,
/turf/open/floor/plating,
/area/ship/engineering/engine)
"BU" = (
/obj/structure/railing/thin{
	dir = 1
	},
/obj/structure/catwalk/over,
/obj/machinery/power/apc/auto_name/directional/west,
/obj/structure/punching_bag,
/obj/structure/cable{
	icon_state = "0-2"
	},
/obj/item/cigbutt/cigarbutt{
	pixel_x = -7;
	pixel_y = 3
	},
/obj/item/spacecash/bundle/smallrand,
/turf/open/floor/plating,
/area/ship/engineering/engine)
"Cq" = (
/obj/structure/grille,
/obj/structure/window/plasma/reinforced/plastitanium,
/obj/machinery/door/poddoor/shutters{
	id = "javelin_viewport_shutters"
	},
/turf/open/floor/plating,
/area/ship/bridge)
"CW" = (
/obj/effect/turf_decal/techfloor{
	dir = 4
	},
/obj/structure/table/reinforced,
/obj/machinery/jukebox/boombox{
	pixel_x = -8;
	pixel_y = -3
	},
/obj/item/folder/yellow{
	pixel_x = 10
	},
/obj/item/paper{
	pixel_x = 10;
	pixel_y = -4
	},
/obj/item/paper{
	pixel_x = 10;
	pixel_y = -2
	},
/obj/item/radio{
	pixel_x = 8;
	pixel_y = 3
	},
/turf/open/floor/plasteel/tech,
/area/ship/bridge)
"De" = (
/obj/machinery/power/port_gen/pacman{
	anchored = 1
	},
/obj/structure/cable/yellow,
/obj/machinery/firealarm/directional/east{
	pixel_y = 7
	},
/obj/structure/extinguisher_cabinet/directional/east{
	pixel_y = -5
	},
/obj/structure/cable{
	icon_state = "5-9"
	},
/turf/open/floor/plating,
/area/ship/engineering/engine)
"DE" = (
/obj/machinery/atmospherics/pipe/layer_manifold{
	dir = 4
	},
/obj/structure/grille,
/obj/structure/window/plasma/reinforced/plastitanium,
/obj/machinery/door/poddoor/shutters{
	id = "javelin_helm_shutters";
	dir = 8
	},
/turf/open/floor/plating,
/area/ship/bridge)
"DK" = (
/turf/closed/wall/mineral/plastitanium,
/area/ship/engineering/engine)
"EE" = (
/obj/structure/closet/secure_closet/wall/directional/west{
	icon_door = "solgov_wall";
	icon_state = "solgov_wall";
	name = "enforcer's locker";
	req_access_txt = "1"
	},
/obj/item/storage/backpack/messenger/inteq,
/obj/item/clothing/suit/hooded/wintercoat/security/inteq/alt,
/obj/item/clothing/suit/hooded/wintercoat/security/inteq,
/obj/item/clothing/head/soft/inteq,
/obj/item/clothing/head/beret/sec/inteq,
/obj/item/clothing/shoes/combat,
/obj/item/clothing/shoes/sneakers/black,
/obj/item/clothing/under/syndicate/inteq/skirt,
/obj/item/clothing/under/syndicate/inteq,
/obj/item/modular_computer/laptop/preset/civilian,
/turf/open/floor/carpet/orange,
/area/ship/bridge)
"Fu" = (
/obj/structure/cable{
	icon_state = "2-8"
	},
/obj/structure/cable{
	icon_state = "1-8"
	},
/obj/effect/turf_decal/industrial/caution{
	dir = 8
	},
/obj/item/clothing/head/cone{
	pixel_y = 12;
	pixel_x = 1
	},
/turf/open/floor/plasteel/patterned,
/area/ship/cargo)
"FL" = (
/obj/effect/turf_decal/industrial/traffic,
/obj/effect/turf_decal/box/corners{
	dir = 4
	},
/obj/effect/turf_decal/box/corners{
	dir = 1
	},
/obj/effect/turf_decal/borderfloorblack{
	dir = 1
	},
/obj/structure/guncloset{
	open = 0;
	anchored = 1
	},
/obj/item/gun/ballistic/automatic/assault/skm/inteq,
/obj/item/gun/ballistic/automatic/pistol/commander/inteq,
/turf/open/floor/plasteel/patterned/cargo_one,
/area/ship/cargo)
"GC" = (
/obj/machinery/atmospherics/pipe/manifold/supply/hidden/layer2{
	dir = 1
	},
/obj/structure/cable{
	icon_state = "4-8"
	},
/obj/effect/turf_decal/spline/fancy/opaque/black/corner{
	dir = 8
	},
/obj/effect/turf_decal/siding/thinplating/dark/corner{
	dir = 8
	},
/obj/effect/turf_decal/trimline/opaque/yellow/corner{
	dir = 8
	},
/obj/effect/turf_decal/trimline/opaque/yellow/line{
	dir = 1
	},
/obj/machinery/holopad/emergency/security,
/obj/machinery/atmospherics/pipe/simple/scrubbers/hidden/layer4{
	dir = 8
	},
/obj/effect/turf_decal/siding/thinplating/dark/corner{
	dir = 1
	},
/obj/effect/turf_decal/siding/thinplating/dark/corner{
	dir = 4
	},
/turf/open/floor/plasteel/dark,
/area/ship/bridge)
"GD" = (
/obj/docking_port/stationary{
	dir = 4;
	dwidth = 20;
	height = 40;
	width = 40;
	name = "javelin cargo dock";
	dheight = 20
	},
/turf/template_noop,
/area/template_noop)
"GJ" = (
/obj/structure/cable{
	icon_state = "2-4"
	},
/obj/structure/chair/handrail,
/obj/item/cigbutt{
	pixel_x = -12;
	pixel_y = 4
	},
/obj/effect/decal/cleanable/dirt/dust,
/turf/open/floor/plasteel/patterned,
/area/ship/cargo)
"JU" = (
/turf/closed/wall/mineral/plastitanium/nodiagonal,
/area/ship/cargo)
"Ke" = (
/obj/machinery/atmospherics/pipe/simple/supply/hidden/layer2{
	dir = 4
	},
/obj/effect/turf_decal/hardline_small/left,
/obj/structure/closet/crate/secure/plasma,
/obj/item/stack/sheet/mineral/plasma/twenty{
	amount = 40
	},
/obj/structure/cable{
	icon_state = "1-4"
	},
/obj/effect/decal/cleanable/dirt/dust,
/turf/open/floor/plasteel/tech,
/area/ship/engineering/engine)
"Kf" = (
/obj/structure/chair/comfy/shuttle{
	dir = 1
	},
/obj/effect/turf_decal/corner/opaque/yellow{
	dir = 1
	},
/obj/effect/turf_decal/corner/opaque/brown{
	dir = 4
	},
/obj/effect/turf_decal/corner/opaque/brown{
	dir = 8
	},
/obj/effect/turf_decal/corner/opaque/yellow,
/obj/effect/turf_decal/spline/fancy/opaque/black{
	dir = 1
	},
/obj/effect/landmark/start/security_officer,
/obj/effect/turf_decal/spline/fancy/opaque/black{
	dir = 4
	},
/obj/effect/turf_decal/spline/fancy/opaque/black{
	dir = 8
	},
/turf/open/floor/plasteel/mono/dark,
/area/ship/bridge)
"KV" = (
/obj/machinery/power/shuttle/engine/electric,
/obj/structure/cable/yellow{
	icon_state = "0-4"
	},
/turf/open/floor/engine/hull/reinforced,
/area/ship/engineering/engine)
"Ls" = (
/obj/effect/turf_decal/techfloor{
	dir = 1
	},
/obj/item/food/donut/choco{
	pixel_x = -1;
	pixel_y = -1
	},
/obj/machinery/computer/helm{
	icon_state = "computer-middle"
	},
/turf/open/floor/plasteel/telecomms_floor,
/area/ship/bridge)
"Lv" = (
/obj/machinery/recharger{
	pixel_x = -8
	},
/obj/item/storage/secure/safe{
	pixel_y = -32
	},
/obj/effect/turf_decal/siding/thinplating/dark{
	dir = 6
	},
/obj/effect/turf_decal/trimline/opaque/yellow/warning{
	dir = 6
	},
/obj/machinery/firealarm/directional/east{
	pixel_y = 7
	},
/obj/structure/extinguisher_cabinet/directional/east{
	pixel_y = -5
	},
/obj/structure/table,
/obj/item/storage/pouch/squad{
	pixel_x = 7
	},
/obj/item/flashlight/seclite{
	pixel_x = 1;
	pixel_y = 11
	},
/turf/open/floor/plasteel/dark,
/area/ship/bridge)
"Lx" = (
/obj/structure/grille,
/obj/structure/window/plasma/reinforced/plastitanium,
/turf/open/floor/plating,
/area/ship/cargo)
"Ma" = (
/obj/structure/railing/thin/corner{
	dir = 8
	},
/obj/structure/cable{
	icon_state = "1-2"
	},
/obj/machinery/atmospherics/components/unary/vent_pump/on/layer2{
	dir = 1
	},
/obj/effect/decal/cleanable/dirt/dust,
/obj/item/trash/chips,
/turf/open/floor/plasteel/tech,
/area/ship/engineering/engine)
"Mj" = (
/obj/machinery/portable_atmospherics/canister/air,
/obj/machinery/atmospherics/components/unary/portables_connector/visible/layer2{
	dir = 4
	},
/obj/structure/sign/warning/nosmoking/burnt{
	pixel_y = 28
	},
/obj/machinery/airalarm/directional/west,
/turf/open/floor/plating,
/area/ship/engineering/engine)
"MT" = (
/obj/structure/sign/poster/contraband/inteq{
	pixel_y = 30
	},
/obj/machinery/power/smes/shuttle/precharged{
	dir = 4
	},
/obj/structure/cable/yellow{
	icon_state = "0-8"
	},
/turf/open/floor/plating,
/area/ship/engineering/engine)
"NV" = (
/obj/machinery/atmospherics/pipe/simple/scrubbers/hidden/layer4{
	dir = 8
	},
/obj/structure/cable{
	icon_state = "4-8"
	},
/obj/machinery/atmospherics/pipe/simple/supply/hidden/layer2{
	dir = 10
	},
/turf/open/floor/plasteel/patterned,
/area/ship/cargo)
"Oa" = (
/obj/structure/cable{
	icon_state = "0-2"
	},
/obj/structure/table/reinforced,
/obj/effect/turf_decal/techfloor{
	dir = 1
	},
/obj/machinery/light_switch{
	dir = 4;
	pixel_x = -20;
	pixel_y = -11
	},
/obj/machinery/light/small/directional/north,
/obj/machinery/fax/inteq,
/obj/machinery/power/apc/auto_name/directional/west,
/turf/open/floor/plasteel/tech,
/area/ship/bridge)
"Oz" = (
/obj/machinery/porta_turret/ship/inteq/light{
	dir = 9;
	id = "javelin";
	name = "Close-In Vanguard turret"
	},
/turf/closed/wall/mineral/plastitanium/nodiagonal,
/area/ship/engineering/engine)
"OC" = (
/obj/structure/cable{
	icon_state = "4-8"
	},
/obj/machinery/door/airlock/external/glass{
	dir = 4
	},
/turf/open/floor/plasteel/patterned,
/area/ship/cargo)
"Qa" = (
/obj/machinery/atmospherics/pipe/simple/supply/hidden/layer2{
	dir = 4
	},
/obj/machinery/atmospherics/pipe/simple/scrubbers/hidden/layer4{
	dir = 8
	},
/obj/structure/cable{
	icon_state = "4-8"
	},
/obj/machinery/door/firedoor/border_only{
	dir = 4
	},
/obj/item/gps{
	pixel_x = 4;
	pixel_y = 6
	},
/turf/open/floor/plasteel/stairs/right{
	dir = 4
	},
/area/ship/bridge)
"Qu" = (
/obj/structure/cable{
	icon_state = "0-8"
	},
/obj/machinery/power/shieldwallgen/atmos/roundstart{
	id = "javelin_holo";
	dir = 1
	},
/obj/effect/turf_decal/industrial/warning/fulltile,
/obj/machinery/door/poddoor{
	id = "javelin_dock_doors";
	dir = 4
	},
/turf/open/floor/engine/hull/reinforced/interior,
/area/ship/cargo)
"Rv" = (
/obj/machinery/atmospherics/pipe/simple/supply/hidden/layer2{
	dir = 4
	},
/obj/structure/cable{
	icon_state = "4-8"
	},
/obj/effect/turf_decal/siding/thinplating/dark,
/obj/effect/turf_decal/siding/thinplating/dark{
	dir = 1
	},
/obj/effect/turf_decal/trimline/opaque/yellow/line,
/obj/effect/turf_decal/trimline/opaque/yellow/line{
	dir = 1
	},
/obj/machinery/atmospherics/pipe/manifold/scrubbers/hidden/layer4,
/obj/effect/decal/cleanable/dirt/dust,
/turf/open/floor/plasteel/dark,
/area/ship/bridge)
"RR" = (
/obj/effect/turf_decal/industrial/traffic,
/obj/effect/turf_decal/borderfloorblack{
	dir = 1
	},
/obj/structure/crate_shelf/built,
/turf/open/floor/plasteel/patterned/cargo_one,
/area/ship/cargo)
"Sh" = (
/turf/closed/wall/mineral/plastitanium/nodiagonal,
/area/ship/bridge)
"Ve" = (
/obj/machinery/porta_turret/ship/inteq/heavy{
	dir = 5;
	id = "javelin";
	name = "Vanguard Overwatch turret"
	},
/turf/closed/wall/mineral/plastitanium,
/area/ship/cargo)
"WP" = (
/obj/structure/cable{
	icon_state = "0-8"
	},
/obj/machinery/power/shieldwallgen/atmos/roundstart{
	id = "javelin_holo"
	},
/obj/effect/turf_decal/industrial/warning/fulltile,
/obj/machinery/door/poddoor{
	id = "javelin_dock_doors";
	dir = 4
	},
/turf/open/floor/engine/hull/reinforced/interior,
/area/ship/cargo)
"Ym" = (
/turf/closed/wall/mineral/plastitanium/nodiagonal,
/area/ship/engineering/engine)
"Zk" = (
/obj/machinery/porta_turret/ship/inteq/light{
	dir = 10;
	id = "javelin";
	name = "Close-In Vanguard turret"
	},
/turf/closed/wall/mineral/plastitanium/nodiagonal,
/area/ship/engineering/engine)
"Zr" = (
/obj/structure/bed,
/obj/structure/curtain/bounty,
/obj/item/bedsheet/brown,
/obj/machinery/button/door{
	dir = 4;
	id = "javelin_viewport_shutters";
	pixel_x = -21;
	pixel_y = 2;
	name = "viewport shutters toggle"
	},
/obj/machinery/light_switch{
	dir = 4;
	pixel_x = -20;
	pixel_y = 11
	},
/turf/open/floor/carpet/orange,
/area/ship/bridge)

(1,1,1) = {"
qu
KV
DK
Ym
DK
KV
qu
"}
(2,1,1) = {"
Oz
gu
Ym
Mj
Ym
gu
Zk
"}
(3,1,1) = {"
Ym
MT
BU
Ke
BR
rM
Ym
"}
(4,1,1) = {"
Ym
nk
bn
fw
Ma
rf
Ym
"}
(5,1,1) = {"
DK
Ym
yi
BL
De
Ym
DK
"}
(6,1,1) = {"
aI
Ym
Ym
ek
Ym
Ym
Ym
"}
(7,1,1) = {"
DE
Sh
Oa
hp
EE
Zr
Cq
"}
(8,1,1) = {"
fj
kr
uj
Rv
zK
nv
Cq
"}
(9,1,1) = {"
uI
Ls
Kf
GC
qH
BP
Sh
"}
(10,1,1) = {"
uI
Ai
CW
uw
oE
Lv
Sh
"}
(11,1,1) = {"
vp
Sh
AD
Qa
kX
Sh
kU
"}
(12,1,1) = {"
qu
JU
FL
dP
hF
JU
qu
"}
(13,1,1) = {"
qu
JU
RR
NV
fS
JU
qu
"}
(14,1,1) = {"
qu
JU
ud
ag
lI
JU
qu
"}
(15,1,1) = {"
qu
JU
Lx
OC
Lx
JU
qu
"}
(16,1,1) = {"
qu
JU
GJ
Fu
rG
JU
qu
"}
(17,1,1) = {"
qu
Ve
WP
oO
Qu
sZ
qu
"}
(18,1,1) = {"
qu
qu
qu
GD
qu
qu
qu
"}
